{
  "maze1": {
    "id": 1,
    "name": "Maze 1",
    "matrix": [
      [0, 0, 0, 0, 0, 0, 0, 0, 0],
      [0, 0, 0, 0, 0, 0, 0, 0, 0],
      [1, 1, 0, 0, 0, 0, 0, 0, 0],
      [5, 3, 1, 1, 1, 1, 1, 0, 0],
      [1, 3, 1, 0, 0, 0, 1, 0, 0],
      [1, 3, 3, 2, 1, 0, 1, 0, 0],
      [0, 1, 1, 1, 1, 4, 1, 0, 0],
      [0, 0, 0, 0, 1, 1, 1, 0, 0],
      [0, 0, 0, 0, 0, 0, 0, 0, 0]
    ]
  },
  "maze2": {
    "id": 2,
    "name": "Maze 2",
    "matrix": [
      [0, 0, 0, 0, 0, 0, 0, 0, 0],
      [0, 0, 0, 0, 0, 0, 0, 0, 0],
      [1, 1, 0, 0, 0, 0, 0, 0, 0],
      [5, 3, 1, 1, 1, 1, 1, 0, 0],
      [1, 3, 1, 3, 3, 3, 1, 0, 0],
      [1, 3, 3, 3, 1, 3, 1, 0, 0],
      [0, 1, 1, 1, 1, 4, 1, 0, 0],
      [0, 0, 0, 0, 1, 1, 1, 0, 0],
      [0, 0, 0, 0, 0, 0, 0, 0, 0]
    ]
  }
}
